11111111111111111111111111111111
1NNNNNNNNNNNNNNNNNNNNNNNNNNNNNN1
1NNNNNNNNNNNNNNNNNNNNNNNNNNNNNN1
1NNNNNNNNNNNNNCCCCCNNNNNNNNNNNN1
1NNNNNNNNNNNNNCCPCCNNNNNNNNNNNN1
1NNNNNNNNNNNNNCCCCCNNNNNNNNNNNN1
1NNNNNNNNNNNNNNNNNNNNNNNNNNNNNN1
1NNNNNNNNNNNNNNNNNNNNNNNNNNNENN1
11111111111111111111111111111111