1111111111111111111111
1P000C00E00000000000n1
10000C000000011nc00001
1111111111111111111111