111111111111111111111111111111111111111111111111111111111111111
111111111111111111111111111111111111111111111111111111111111111
10000000C00000c0000000000000C0000000000000000000000000000000001
10000000000000000000000000000000000000000000000C000000000000001
100000000000000000000C00000000000000000000000000000000000000001
1000000000000E0000000000000000000000000000000000000000000000001
100000000000000000000000000001111100000000000000000000000000001
100000000000000000000000000011111110000000000000000000000000001
10000000000000000000000000011111111100000000000000C000000000001
100000000000C00000000000001111111111100000000000000000000000001
100000000000000000000000011111111111110000C0000000c000000000001
100000000000000000000000011111111111110000000000000000000000001
100000000000000000000000001111111111100000000000000000000000001
10000000000000000c000000000111111111000000000000000000000000001
1000000000000000000000000000111111100000000000000C0000000000001
100000000C00000000000000000001111100000000000000000000000000001
100000000000000000000000000000000000000000000000000000c00000001
100000000000000000000000000000000000000000000000000000000000001
100000000000000000000000000000000000000000000000000000000000001
100000000000C000000000c00000000000000000000000000000C0000000001
100000000000000000000000000000000000000000000000000000000000001
10000000000000000000000000000000000000C000000000000000000000001
111111111111111111111111111111011111111111111111111111111111111
111111111111111111111111111111011111111111111111111111111111111
10000000C00000c0000000000000C0000000000000000000000000000000001
10000000000000000000000000000000000000000000000C000000000000001
100000000000000000000C00000000000000000000000000000000000000001
100000000000000000000000000000000000000000000000000000000000001
100000000000000000000000000001111100000000000000000000000000001
100000000000000000000000000011111110000000000000000000000000001
10000000000000000000000000011111111100000000000000C000000000001
100000000000C00000000000001111111111100000000000000000000000001
100000000000000000000000011111111111110000C0000000c000000000001
100000000000000000000000011111111111110000000000000000000000001
100000000000000000000000001111111111100000000000000000000000001
10000000000000000c000000000111111111000000000000000000000000001
1000000000000000000000000000111111100000000000000C0000000000001
100000000C00000000000000000001111100000000000000000000000000001
100000000000000000000000000000000000000000000000000000c00000001
100000000000000000000000000000000000000000000000000000000000001
100000000000000000000000000000000000000000000000000000000000001
100000000000C000000000c00000000000000000000000000000C0000000001
100000000000000000000000000000000000000000000000000000000000001
10000000000000000000000000000000000000C000000000000000000000001
111111111111111111111111111111011111111111111111111111111111111
111111111111111111111111111111011111111111111111111111111111111
10000000C00000c0000000000000C0000000000000000000000000000000001
10000000000000000000000000000000000000000000000C000000000000001
100000000000000000000C00000000000000000000000000000000000000001
100000000000000000000000000000000000000000000000000000000000001
100000000000000000000000000001111100000000000000000000000000001
100000000000000000000000000011111110000000000000000000000000001
10000000000000000000000000011111111100000000000000C000000000001
100000000000C00000000000001111111111100000000000000000000000001
100000000000000000000000011111111111110000C0000000c000000000001
100000000000000000000000011111111111110000000000000000000000001
100000000000000000000000001111111111100000000000000000000000001
10000000000000000c000000000111111111000000000000000000000000001
1000000000000000000000000000111111100000000000000C0000000000001
100000000C00000000000000000001111100000000000000000000000000001
100000000000000000000000000000000000000000000000000000c00000001
100000000000000000000000000000000000000000000000000000000000001
100000000000000000000000000000000000000000000000000000000000001
100000000000C000000000c00000000000000000000000000000C0000000001
100000000000000000000000000000000000000000000000000000000000001
10000000000000000000000000000000000000C000000000000000000000001
111111111111111111111111111111011111111111111111111111111111111
111111111111111111111111111111011111111111111111111111111111111
10000000C00000c0000000000000C0000000000000000000000000000000001
10000000000000000000000000000000000000000000000C000000000000001
100000000000000000000C00000000000000000000000000000000000000001
100000000000000000000000000000000000000000000000000000000000001
100000000000000000000000000001111100000000000000000000000000001
100000000000000000000000000011111110000000000000000000000000001
10000000000000000000000000011111111100000000000000C000000000001
100000000000C00000000000001111111111100000000000000000000000001
100000000000000000000000011111111111110000C0000000c000000000001
100000000000000000000000011111111111110000000000000000000000001
100000000000000000000000001111111111100000000000000000000000001
10000000000000000c000000000111111111000000000000000000000000001
1000000000000000000000000000111111100000000000000C0000000000001
100000000C00000000000000000001111100000000000000000000000000001
100000000000000000000000000000000000000000000000000000c00000001
100000000000000000000000000000000000000000000000000000000000001
100000000000000000000000000000000000000000000000000000000000001
100000000000C000000000c00000000000000000000000000000C0000000001
100000000000000000000000000000000000000000000000000000000000001
10000000000000000000000000000000000000C000000000000000000000001
111111111111111111111111111111011111111111111111111111111111111
111111111111111111111111111111011111111111111111111111111111111
10000000C00000c0000000000000C0000000000000000000000000000000001
10000000000000000000000000000000000000000000000C000000000000001
100000000000000000000C00000000000000000000000000000000000000001
100000000000000000000000000000000000000000000000000000000000001
100000000000000000000000000001111100000000000000000000000000001
100000000000000000000000000011111110000000000000000000000000001
10000000000000000000000000011111111100000000000000C000000000001
100000000000C00000000000001111111111100000000000000000000000001
100000000000000000000000011111111111110000C0000000c000000000001
100000000000000000000000011111111111110000000000000000000000001
100000000000000000000000001111111111100000000000000000000000001
10000000000000000c000000000111111111000000000000000000000000001
1000000000000000000000000000111111100000000000000C0000000000001
100000000C00000000000000000001111100000000000000000000000000001
100000000000000000000000000000000000000000000000000000c00000001
100000000000000000000000000000000000000000000000000000000000001
100000000000000000000000000000000000000000000000000000000000001
100000000000C000000000c00000000000000000000000000000C0000000001
100000000000000000000000000000000000000000000000000000000000001
10000000000000000000000000000000000000C000000000000000000000001
111111111111111111111111111111011111111111111111111111111111111
111111111111111111111111111111011111111111111111111111111111111
10000000C00000c0000000000000C0000000000000000000000000000000001
10000000000000000000000000000000000000000000000C000000000000001
100000000000000000000C00000000000000000000000000000000000000001
100000000000000000000000000000000000000000000000000000000000001
100000000000000000000000000001111100000000000000000000000000001
100000000000000000000000000011111110000000000000000000000000001
10000000000000000000000000011111111100000000000000C000000000001
100000000000C00000000000001111111111100000000000000000000000001
100000000000000000000000011111111111110000C0000000c000000000001
100000000000000000000000011111111111110000000000000000000000001
100000000000000000000000001111111111100000000000000000000000001
10000000000000000c000000000111111111000000000000000000000000001
1000000000000000000000000000111111100000000000000C0000000000001
100000000C00000000000000000001111100000000000000000000000000001
100000000000000000000000000000000000000000000000000000c00000001
100000000000000000000000000000000000000000000000000000000000001
100000000000000000000000000000000000000000000000000000000000001
100000000000C000000000c00000000000000000000000000000C0000000001
100000000000000000000000000000000000000000000000000000000000001
10000000000000000000000000000000000000C000000000000000000000001
111111111111111111111111111111011111111111111111111111111111111
111111111111111111111111111111011111111111111111111111111111111
10000000C00000c0000000000000C0000000000000000000000000000000001
10000000000000000000000000000000000000000000000C000000000000001
100000000000000000000C00000000000000000000000000000000000000001
100000000000000000000000000000000000000000000000000000000000001
100000000000000000000000000001111100000000000000000000000000001
100000000000000000000000000011111110000000000000000000000000001
10000000000000000000000000011111111100000000000000C000000000001
100000000000C00000000000001111111111100000000000000000000000001
100000000000000000000000011111111111110000C0000000c000000000001
100000000000000000000000011111111111110000000000000000000000001
100000000000000000000000001111111111100000000000000000000000001
10000000000000000c000000000111111111000000000000000000000000001
1000000000000000000000000000111111100000000000000C0000000000001
100000000C00000000000000000001111100000000000000000000000000001
100000000000000000000000000000000000000000000000000000c00000001
100000000000000000000000000000000000000000000000000000000000001
100000000000000000000000000000000000000000000000000000000000001
100000000000C000000000c00000000000000000000000000000C0000000001
100000000000000000000000000000000000000000000000000000000000001
10000000000000000000000000000000000000C000000000000000000000001
111111111111111111111111111111011111111111111111111111111111111
111111111111111111111111111111011111111111111111111111111111111
10000000C00000c0000000000000C0000000000000000000000000000000001
10000000000000000000000000000000000000000000000C000000000000001
100000000000000000000C00000000000000000000000000000000000000001
100000000000000000000000000000000000000000000000000000000000001
100000000000000000000000000001111100000000000000000000000000001
100000000000000000000000000011111110000000000000000000000000001
10000000000000000000000000011111111100000000000000C000000000001
100000000000C00000000000001111111111100000000000000000000000001
100000000000000000000000011111111111110000C0000000c000000000001
100000000000000000000000011111111111110000000000000000000000001
100000000000000000000000001111111111100000000000000000000000001
10000000000000000c000000000111111111000000000000000000000000001
1000000000000000000000000000111111100000000000000C0000000000001
100000000C00000000000000000001111100000000000000000000000000001
100000000000000000000000000000000000000000000000000000c00000001
100000000000000000000000000000000000000000000000000000000000001
100000000000000000000000000000000000000000000000000000000000001
100000000000C000000000c00000000000000000000000000000C0000000001
100000000000000000000000000000000000000000000000000000000000001
10000000000000000000000000000000000000C000000000000000000000P01
111111111111111111111111111111111111111111111111111111111111111