11111111111111111111111111111111
10000000C00000c0000000000000C001
10000000C00000c0000000000000C001
10000000C00000c0000000000000C001
10000000C00000c0000000000000C001
10000000C00000c0000000000000C001
10000000C00000c0000000000000C001
10000000C00000c0000000E00000C001
10000000C00000c0000000000000C001
11111111111111111111111111111111