1111111111111111111111111111
1E00001100000011000000000C11
11000P1100110011001n1n1n1111
11000000001100000000000000C1
1111111111111111111111111111